
Mary	 Price
Stephanie	 Watson
Rachel	 Rivera
Raymond	 Powell
Catherine	 Ward
Doris	 Howard
Cynthia	 Jenkins
Betty	 Torres
Juan	Cox
Kathleen	 Anderson
Mark	Russell
Gerald	Edwards
Mikhail	Nesterenko
Charles	Martin
Linda	Johnson
David 	Collins
Elizabeth	Wood
Jonathan	Baker
Maria	Kelly
Martin	Green
Dennis	White
Brian	Sanchez
